*This is comment which is not effective on settings.
APPLY_SCALE_MIN	false
CONTOUR_LABELS	true
DEEP_CONTOUR	10
DISPLAY_MODE	2
DrawingType	1
LIGHTS	false
OVER_GROUP	2147483647
SAFETY_DEPTH	10
SAFETY_CONTOUR	10
SHALLOW_CONTOUR	5
DISPLAY_FONT_NAME	10
DISPLAY_FONT_SIZE	10
SHALLOW_PATTERN	false
SHOW_ISOLATED_DANGER_IN_SHALLOW_WATER	false
FULL_SECTORS	false
SHOW_NOBJNM	true
SHOW_LIST_ABBREVIATION	false
WGS84_TEXT_TYPE	false
SOUNDING	true
SymbolizedAreaBoundary	true
SeabedType	false
TEXTOUT	true
TWO_SHADES	false
AUTOSELECTION_CATALOGUE	false
m_eColorTable	2
UNIT_DISTANCE	0
S111_SHOW_NODATA	false
Show_INFORM01	true
OBJECT_SHOW_SETTING_BEGIN
OBJECT_SHOW_SETTING_END
OBJECT_SHOW_SETTING_S101_BEGIN
OBJECT_SHOW_SETTING_S101_END
